R 900 900
NO ./textures/sand.XPM
SO ./textures/stone_brick.XPM
WE ./textures/fuhrer.xpm
EA ./textures/wood.XPM
S  ./textures/barrel.xpm
S2 ./textures/pillar.xpm
S3 ./textures/barrel_gold.xpm
F 220,100,3
C 225,30,0


                      111 111         
                      101 121         
        111111111111111011101111111111
        10000000001100E000000000033331
        101100000111000000200000000041
        100100000000044000000000033331
11111111101100000111000000000030111111
100000000011000001110111111111111
11110111111111011100000010001
11110111111111011101010010001
11000000110101011100000010001
10002000000000001100000010001
10000000000000001101010010001
1100000111010101111101111000111
11110111 1110101 101111010001
11111111 1111111 111111111111